#]###############
#.#...a.#k.w#...#
#.#.###.#####i#.#
#.#c#.#..r....#p#
#y#.#.#########.#
#...#.b.#...s...#
#########.#######
#.#.o....n#k....#
#g#.#######.###l#
#a#..C#...#...#.#
#####.#n#.###m#.#
#.n.#...#a....#.#
#j#b###########.#
#.#e.x#..e..#r#i#
#######.###.###.#
#T....h.#.#.M...#
#[###############
